......####
###..#...#
####...###
####.##..#
#..#..#.##
#.##.##..#
..#.....##
.##..####.
....##....
.##....###
\robot 8 8
\robot 5 0
\robot 7 5
