##.#.#
#....#
#.#..#
#....#
#....#
#.#.##