#.#.......####.
..##.####......
........###.###
.##.#.#.###..##
###.##...##.#.#
#...###.###.#.#
#..###..##....#
##....##..##.##
#####.#.#....##
..##..#.....###
#....#.#.##.#.#
..##.#.###.....
.#.....###.#.##
.#####.###.#..#
.#.....######..
\robot 8 5
\robot 12 1
\robot 7 8
