######....###.###..#
##...###....#.####..
...#.###.#.........#
..##.####.##.#######
.###.........#######
#####.###.##...#....
#.#.#.#.###..###.##.
#.....#.###..###.###
##...#...##.####..##
##.#...####........#
##.##.#.#######..#..
#..####.#........#..
....#.#.#.#.#.##..##
#..#..#...###.#..###
.#..#.#.#.#..##.###.
...#..#.#....##.....
#..#.######.######.#
##...##...###.##...#
...........##.#..#..
.#.##..##.....##.###
\robot 2 6
\robot 18 9
\robot 5 10
